ingredient	quantity
Pasta fillo	3 fogli
Semi di sesamo nero	q.b.
Burro fuso	30 g
Gamberi già puliti	12
Olio extravergine d'oliva	2 cucchiai
Fiocchi di sale	1 cucchiaino
Miele di castagno	1 cucchiaino
Succo di limone	½
Pepe nero	q.b.
Avocado	1
Succo di lime	½
Sale fino	q.b.
Tabasco®	q.b.
Olio extravergine d'oliva	1 cucchiaio
Tuorli (di uova medie)	2
Succo di mandarino	1
Scorza d'arancia	1
Scorza di limone	1
Olio di semi di girasole	250 g
Sale fino	q.b.
Pepe nero	q.b.
Uova di salmone	10 g