Cinghiale	 1,5 kg 
Carote	 3 
Sedano	 4 coste 
Cipolle bianche	 2 
Aglio	 3 spicchi 
Rosmarino	 1 rametto 
Vino rosso	 100 g 
Sale fino	 q.b. 
Pepe nero	 q.b. 
Olio extravergine d'oliva	 30 g 
Concentrato di pomodoro	 75 g 
Timo	 q.b. 
Salvia	 q.b. 
Maggiorana	 q.b. 
Cioccolato fondente	 10 g 
Bacche di ginepro	 q.b. 
Brodo vegetale	 1 l 
Vino rosso	 600 g 
Carote	 1 
Sedano	 1 costa 
Cipolle bianche	 1 
Pepe nero in grani	 q.b. 
Alloro	 4 foglie 