ingredient	quantity
Camembert pezzi da 250 g ciascuno	2
Rosmarino	q.b.
Salvia	q.b.
Origano	q.b.
Pepe nero	q.b.
Olio extravergine d'oliva	q.b.
Farina di farro integrale	100 g
Olio extravergine d'oliva	25 g
Acqua	50 g
Sale fino	q.b.
Cipolle rosse	350 g
Scalogno	60 g
Rosmarino rametto	1
Salvia mazzetto	1
Cannella in stecche	1
Olio extravergine d'oliva	q.b.
Zucchero di canna	25 g
Vino rosso Bordeaux	70 g
Sale fino	q.b.
Pepe nero	q.b.