ingredient	quantity
Pasta Sfoglia	460 g
Uova	1
Formaggio fresco spalmabile	130 g
Prosciutto cotto	60 g
Basilico	2 foglie
Olio extravergine d'oliva	q.b.
Sale fino	q.b.
Pepe nero	q.b.
Formaggio fresco spalmabile	190 g
Mortadella	120 g
Pistacchi	40 g
Olio extravergine d'oliva	q.b.
Panna fresca liquida (facoltativa)	q.b.
Zucchine	Â½
Pomodori	1
Sedano	1 costa
Fagiolini	70 g
Carote	1
Prezzemolo	q.b.
Menta	q.b.