Gamberi	 (da pulire) 6 
Seppie	 (pulite) 400 g 
Gallinella	 (da pulire) 550 g 
Coda di rospo	 (da pulire) 500 g 
Triglie	 (da pulire) 550 g 
Olio extravergine d'oliva	 q.b. 
Aglio	 2 spicchi 
Prezzemolo	 q.b. 
Vino bianco	 50 g 
Sale fino	 q.b. 
Pepe nero	 q.b. 
Passata di pomodoro	 500 g 
Sedano	 1 costa 
Carote	 1 
Cipolle bianche	 1 
Acqua	 1,5 l 
Pepe bianco in grani	 ( o pepe nero) q.b. 
Prezzemolo	 q.b. 
Cozze	 1 kg 
Olio extravergine d'oliva	 q.b. 
Aglio	 1 spicchio 