ingredient	quantity
Panettone milanese 8 fette da 50g	ciascuna
Mandorle in scaglie	q.b.
Pomodori secchi sott'olio	60 g
Burro (per ungere la padella)	q.b.
Vitello	800 g
Aglio spicchio	1
Carote	1
Sedano costa	1
Cipolle dorate	1
Alloro foglia	1
Chiodi di garofano	3
Pepe nero in grani	q.b.
Sale fino	q.b.
Acqua	1,5 l
Vino bianco	250 g
Olio extravergine d'oliva cucchiai	3
Catalogna	350 g
Peperoncino fresco	1
Aglio spicchio	1
Olio extravergine d'oliva	q.b.
Sale fino	q.b.